5
1 38 -1
10 1 -1
10 38 -1
18 1 -1
18 38 -1
xxxxxxxxxxxxxxxxxxxxxxxxxxxxxxxxxxxxxxxx
xS                                    +x
x                                      x
x                                      x
x                                      x
x                                      x
x                                      x
x                                      x
x                                      x
x                                      x
x+                                    +x
x                                      x
x                                      x
x                                      x
x                                      x
x                                      x
x                                      x
x                                      x
x+                                    +x
xxxxxxxxxxxxxxxxxxxxxxxxxx xxxxxxxxxxxxx