5
10 1 -1
18 1 -1
18 38 -1
10 38 -1
1 38 -1
xxxxxxxxxxxxxxxxxxxxxxxxxx xxxxxxxxxxxxx
xS                                    +x
x                                      x
x                                      x
x                                      x
x                                      x
x                                      x
x                                      x
x                                      x
x                                      x
x+                                    +x
x                                      x
x                                      x
x                                      x
x                                      x
x                                      x
x                                      x
x                                      x
x+                                    +x
xxxxxxxxxxxxxxxxxxxxxxxxxxxxxxxxxxxxxxxx